######################################
#A                  #               B#
# ####### #### ##### #### ########## #
#       # #    #                     #
##### # # ## ######### ###### ########
#   # #    #        ##      #        #
# # ######### ######### ####### #### #
# # #                 #       #    # #
# # ### ###### ######### # ##### ### #
#     # #                            #
# ### # #### ##### ### #### ######## #
#            #     # #               #
#### ########### ##### ##### ####### #
#                   #   # #          #
# ######### ### # ### ### ###### ### #
# #     #     # #   #   #            # 
# ##### ##### # ##### ##### ##########
#     #   #   #   #   #              #
####### ### ##### ##### ##############
#     #       #   #                  #
# ####### ### ##### ### ##############
#       #   #         #              #
######################################